###########
#c#___#___#
#_#_#_#_#_#
#_#_#_#_#_#
#_#_#_#_#_#
#_#_#_#_#_#
#_#_#_#_#_#
#_#_#_#_#_#
#___#___#_#
###########